1111111
10C0111
1P100E1
1111111
