1111111
1P00001
1010111
1010101
10100E1
1111111
