1111111
1P00001
101C111
1110101
1C100E1
1111111
