11111111111111111111111111111
10000000000000000000000000001
1000E0000000000000000C0000001
10000000000000000000000000001
1000000000000000C00000000P001
1000000000C000000000000000001
1000C000000000000000000000001
11111111111111111111111111111
